############################################
###     .      .           .       .     ###
### ########## ## ######## ## ########## ###
### ####  ####.##          ##.####  #### ###
### ########## ## ###  ### ## ########## ###
###            ##.###  ###.##            ###
### ############# ###  ### ############# ###
###.####   .                    .   ####.###
### ####  #########  ..  #########  #### ###
###      .                    .          ###
### ############# ######## ############# ###
###     .         ###  ###       .       ###
### ########## ## ######## ## ########## ###
### ####  #### ##    .     ## ####  #### ###
###.##########.##.########.##.##########.###
###            ## ###  ### ##            ###
###.############# ######## #############.###
###  ===8                                ###
############################################
