################################
#o....##.................#....o#
#.###.##.###.#######.###.#.###.#
#.#...##.#......#......#.#...#.#
#...####.#.####.#.####....##...#
###.##...#.#.........#.##..###.#
###.##.###.#.### ###.#.###.###.#
 ............# ORPB#........... 
###.##.###.#.#######.#.###.#.###
###.##...#.#....#....#.....#.###
###.####.#.####.#.#####.####.###
###.####.#.####.#.#####.####.###
#o..............G.............o#
################################
