############################################
#                                          #
#  ==8                                     #
#                                          #
#                                          #
#          .                               #
#                                          #
#                                          #
#                                          #
#                                          #
#                                          #
#                                          #
#                                          #
#                                          #
#                                          #
#                                          #
#                                          #
#                                          #
#                                          #
############################################
